0025 0025 0025 0025 0025 0025 0025 0025 0025 0025
0025 0025 0025 0025 0025 0025 0025 0025 0025 0025
0025 0025 0025 0025 0412 0512 0612 0712 0025 0025
0025 0025 0025 0025 0413 0513 0613 0713 0025 0025
0025 0025 0012 0112 0414 0514 0614 0714 0212 0312
0025 0025 0015 0115 0415 0515 0615 0715 0215 0315
0025 0025 0016 0116 0416 0516 0616 0716 0216 0316
0025 0025 0016 0116 0417 0517 0617 0717 0216 0316
0025 0025 0016 0116 0025 3020 3120 0025 0216 0316
0025 0025 0016 0116 0025 3021 3121 0025 0216 0316
0025 0025 0017 0117 0025 0025 0025 0025 0217 0317
0025 0025 1406 1506 0025 2822 2922 0025 1606 1706
0025 0025 1407 0025 0207 2823 2923 0025 0025 1707